0
xxxxxxxxxxxxxxxxxxxxxx
                     x
x                    x
x         x          x
x        x x         x
x       x S x        x
x        x x         x
x         x          x
x                    x
x                    x
xxxxxxxxxxxxxxxxxxxxxx